text_except,data_except,bss_except,dec_except,hex_except,filename_except,text_result,data_result,bss_result,dec_result,hex_result,filename_result
144632,208,4000,148840,24568,except_0.elf,235472,192,2432,238096,3a210,result_0.elf
13880,208,2792,16880,41f0,except_1.elf,8864,192,1224,10280,2828,result_1.elf
43040,208,2960,46208,b480,except_2.elf,37096,192,1392,38680,9718,result_2.elf
27496,208,2912,30616,7798,except_3.elf,30032,192,1344,31568,7b50,result_3.elf
256928,208,4904,262040,3ff98,except_4.elf,411104,192,3328,414624,653a0,result_4.elf
33720,208,2736,36664,8f38,except_5.elf,35152,192,1160,36504,8e98,result_5.elf
13216,208,2720,16144,3f10,except_6.elf,5832,192,1152,7176,1c08,result_6.elf
68656,208,3056,71920,118f0,except_7.elf,127776,192,1488,129456,1f9b0,result_7.elf
40232,208,2776,43216,a8d0,except_8.elf,65976,192,1208,67376,10730,result_8.elf
132736,208,3944,136888,216b8,except_9.elf,247984,192,2376,250552,3d2b8,result_9.elf
45680,208,2856,48744,be68,except_10.elf,76936,192,1280,78408,13248,result_10.elf
57488,208,2960,60656,ecf0,except_11.elf,66168,192,1392,67752,108a8,result_11.elf
59480,208,3016,62704,f4f0,except_12.elf,80080,192,1448,81720,13f38,result_12.elf
11216,208,2760,14184,3768,except_13.elf,2984,192,1192,4368,1110,result_13.elf
179712,208,4200,184120,2cf38,except_14.elf,309664,192,2632,312488,4c4a8,result_14.elf
195872,208,5104,201184,311e0,except_15.elf,364264,192,3528,367984,59d70,result_15.elf
15400,208,2680,18288,4770,except_16.elf,11880,192,1112,13184,3380,result_16.elf
138312,208,3688,142208,22b80,except_17.elf,325544,192,2120,327856,500b0,result_17.elf
141376,208,3432,145016,23678,except_18.elf,222328,192,1856,224376,36c78,result_18.elf
115624,208,3744,119576,1d318,except_19.elf,177752,192,2168,180112,2bf90,result_19.elf
18688,208,2680,21576,5448,except_20.elf,18240,192,1112,19544,4c58,result_20.elf
41280,208,2960,44448,ada0,except_21.elf,24264,192,1392,25848,64f8,result_21.elf
16424,208,2632,19264,4b40,except_22.elf,11056,192,1064,12312,3018,result_22.elf
22056,208,2936,25200,6270,except_23.elf,14664,192,1368,16224,3f60,result_23.elf
22440,208,2824,25472,6380,except_24.elf,20672,192,1256,22120,5668,result_24.elf
45280,208,3400,48888,bef8,except_25.elf,43952,192,1832,45976,b398,result_25.elf
27288,208,2768,30264,7638,except_26.elf,34432,192,1200,35824,8bf0,result_26.elf
23112,208,3032,26352,66f0,except_27.elf,18216,192,1464,19872,4da0,result_27.elf
29904,208,2680,32792,8018,except_28.elf,51552,192,1104,52848,ce70,result_28.elf
94896,208,3160,98264,17fd8,except_29.elf,111128,192,1592,112912,1b910,result_29.elf
50032,208,2840,53080,cf58,except_30.elf,32200,192,1272,33664,8380,result_30.elf
219232,208,4000,223440,368d0,except_31.elf,499096,192,2432,501720,7a7d8,result_31.elf
51472,208,3248,54928,d690,except_32.elf,76536,192,1672,78400,13240,result_32.elf
15736,208,2984,18928,49f0,except_33.elf,6552,192,1416,8160,1fe0,result_33.elf
25144,208,2680,28032,6d80,except_34.elf,25136,192,1112,26440,6748,result_34.elf
20216,208,3360,23784,5ce8,except_35.elf,11440,192,1784,13416,3468,result_35.elf
68136,208,3560,71904,118e0,except_36.elf,91624,192,1992,93808,16e70,result_36.elf
204928,208,3704,208840,32fc8,except_37.elf,426528,192,2128,428848,68b30,result_37.elf
13192,208,2792,16192,3f40,except_38.elf,8432,192,1224,9848,2678,result_38.elf
16568,208,2728,19504,4c30,except_39.elf,14048,192,1160,15400,3c28,result_39.elf
50256,208,2960,53424,d0b0,except_40.elf,78224,192,1392,79808,137c0,result_40.elf
49112,208,2960,52280,cc38,except_41.elf,51624,192,1392,53208,cfd8,result_41.elf
94040,208,3272,97520,17cf0,except_42.elf,187840,192,1704,189736,2e528,result_42.elf
56936,208,2984,60128,eae0,except_43.elf,61624,192,1416,63232,f700,result_43.elf
1124,192,1540,2856,b28,except_44.elf,1568,192,1136,2896,b50,result_44.elf
48120,208,3280,51608,c998,except_45.elf,70808,192,1704,72704,11c00,result_45.elf
18968,208,2648,21824,5540,except_46.elf,11928,192,1080,13200,3390,result_46.elf
11600,208,2768,14576,38f0,except_47.elf,2592,192,1200,3984,f90,result_47.elf
26832,208,2792,29832,7488,except_48.elf,21616,192,1224,23032,59f8,result_48.elf
41792,208,2776,44776,aee8,except_49.elf,66936,192,1208,68336,10af0,result_49.elf
47536,208,2800,50544,c570,except_50.elf,109376,192,1232,110800,1b0d0,result_50.elf
104520,208,3640,108368,1a750,except_51.elf,147664,192,2072,149928,249a8,result_51.elf
201856,208,4712,206776,327b8,except_52.elf,433760,192,3144,437096,6ab68,result_52.elf
28672,208,3216,32096,7d60,except_53.elf,35984,192,1640,37816,93b8,result_53.elf
49376,208,3056,52640,cda0,except_54.elf,87096,192,1488,88776,15ac8,result_54.elf
15992,208,2704,18904,49d8,except_55.elf,13296,192,1136,14624,3920,result_55.elf
124480,208,3656,128344,1f558,except_56.elf,196704,192,2088,198984,30948,result_56.elf
41304,208,2856,44368,ad50,except_57.elf,61136,192,1288,62616,f498,result_57.elf
35608,208,2792,38608,96d0,except_58.elf,55016,192,1224,56432,dc70,result_58.elf
86400,208,3216,89824,15ee0,except_59.elf,167816,192,1640,169648,296b0,result_59.elf
48192,208,3304,51704,c9f8,except_60.elf,61920,192,1736,63848,f968,result_60.elf
48728,208,3720,52656,cdb0,except_61.elf,58304,192,2152,60648,ece8,result_61.elf
47272,208,3200,50680,c5f8,except_62.elf,85088,192,1632,86912,15380,result_62.elf
185200,208,4424,189832,2e588,except_63.elf,335808,192,2856,338856,52ba8,result_63.elf
113744,208,3368,117320,1ca48,except_64.elf,280040,192,1800,282032,44db0,result_64.elf
58688,208,3560,62456,f3f8,except_65.elf,105248,192,1992,107432,1a3a8,result_65.elf
14408,208,2712,17328,43b0,except_66.elf,2728,192,1144,4064,fe0,result_66.elf
29296,208,2888,32392,7e88,except_67.elf,40352,192,1320,41864,a388,result_67.elf
103552,208,3984,107744,1a4e0,except_68.elf,196056,192,2408,198656,30800,result_68.elf
26584,208,2696,29488,7330,except_69.elf,39904,192,1120,41216,a100,result_69.elf
167552,208,3816,171576,29e38,except_70.elf,388808,192,2248,391248,5f850,result_70.elf
205720,208,4360,210288,33570,except_71.elf,427680,192,2792,430664,69248,result_71.elf
60144,208,3944,64296,fb28,except_72.elf,94944,192,2376,97512,17ce8,result_72.elf
22432,208,2856,25496,6398,except_73.elf,11312,192,1280,12784,31f0,result_73.elf
41672,208,2968,44848,af30,except_74.elf,35528,192,1392,37112,90f8,result_74.elf
27872,208,2680,30760,7828,except_75.elf,40592,192,1112,41896,a3a8,result_75.elf
22408,208,3336,25952,6560,except_76.elf,18800,192,1768,20760,5118,result_76.elf
9800,208,2616,12624,3150,except_77.elf,880,192,1048,2120,848,result_77.elf
73672,208,3520,77400,12e58,except_78.elf,118904,192,1952,121048,1d8d8,result_78.elf
9752,208,2624,12584,3128,except_79.elf,1080,192,1048,2320,910,result_79.elf
18880,208,2720,21808,5530,except_80.elf,19584,192,1152,20928,51c0,result_80.elf
178192,208,3496,181896,2c688,except_81.elf,384000,192,1928,386120,5e448,result_81.elf
63152,208,2984,66344,10328,except_82.elf,103160,192,1416,104768,19940,result_82.elf
88952,208,3048,92208,16830,except_83.elf,179648,192,1480,181320,2c448,result_83.elf
146352,208,3520,150080,24a40,except_84.elf,373336,192,1952,375480,5bab8,result_84.elf
26528,208,2792,29528,7358,except_85.elf,9480,192,1224,10896,2a90,result_85.elf
14056,208,2704,16968,4248,except_86.elf,7992,192,1136,9320,2468,result_86.elf
19168,208,2648,22024,5608,except_87.elf,22112,192,1080,23384,5b58,result_87.elf
74440,208,3368,78016,130c0,except_88.elf,98952,192,1800,100944,18a50,result_88.elf
20056,208,2656,22920,5988,except_89.elf,21424,192,1080,22696,58a8,result_89.elf
97048,208,3720,100976,18a70,except_90.elf,203368,192,2152,205712,32390,result_90.elf
11152,208,2712,14072,36f8,except_91.elf,2272,192,1144,3608,e18,result_91.elf
70072,208,3080,73360,11e90,except_92.elf,111880,192,1512,113584,1bbb0,result_92.elf
39136,208,2920,42264,a518,except_93.elf,35912,192,1352,37456,9250,result_93.elf
117128,208,3600,120936,1d868,except_94.elf,114744,192,2032,116968,1c8e8,result_94.elf
17264,208,2792,20264,4f28,except_95.elf,16800,192,1224,18216,4728,result_95.elf
98616,208,3272,102096,18ed0,except_96.elf,178000,192,1704,179896,2beb8,result_96.elf
27288,208,3216,30712,77f8,except_97.elf,30984,192,1640,32816,8030,result_97.elf
129144,208,3368,132720,20670,except_98.elf,333624,192,1800,335616,51f00,result_98.elf
980,192,1524,2696,a88,except_99.elf,1160,192,1112,2464,9a0,result_99.elf
32368,208,2888,35464,8a88,except_100.elf,40280,192,1320,41792,a340,result_100.elf
168352,208,3824,172384,2a160,except_101.elf,278080,192,2256,280528,447d0,result_101.elf
61968,208,3272,65448,ffa8,except_102.elf,92624,192,1704,94520,17138,result_102.elf
37664,208,2752,40624,9eb0,except_103.elf,72264,192,1184,73640,11fa8,result_103.elf
33800,208,3512,37520,9290,except_104.elf,32680,192,1944,34816,8800,result_104.elf
211376,208,3968,215552,34a00,except_105.elf,381776,192,2400,384368,5dd70,result_105.elf
27152,208,2832,30192,75f0,except_106.elf,39288,192,1256,40736,9f20,result_106.elf
37296,208,2768,40272,9d50,except_107.elf,54400,192,1200,55792,d9f0,result_107.elf
10472,208,2680,13360,3430,except_108.elf,1872,192,1112,3176,c68,result_108.elf
37312,208,3280,40800,9f60,except_109.elf,45344,192,1712,47248,b890,result_109.elf
100560,208,3152,103920,195f0,except_110.elf,212984,192,1584,214760,346e8,result_110.elf
58888,208,2864,61960,f208,except_111.elf,130248,192,1296,131736,20298,result_111.elf
106768,208,3104,110080,1ae00,except_112.elf,120384,192,1528,122104,1dcf8,result_112.elf
28144,208,3368,31720,7be8,except_113.elf,32328,192,1800,34320,8610,result_113.elf
59512,208,2920,62640,f4b0,except_114.elf,117144,192,1352,118688,1cfa0,result_114.elf
10336,208,2616,13160,3368,except_115.elf,1664,192,1048,2904,b58,result_115.elf
114152,208,3160,117520,1cb10,except_116.elf,229200,192,1592,230984,38648,result_116.elf
25408,208,2680,28296,6e88,except_117.elf,35848,192,1112,37152,9120,result_117.elf
77384,208,3752,81344,13dc0,except_118.elf,88224,192,2184,90600,161e8,result_118.elf
11296,208,2712,14216,3788,except_119.elf,3112,192,1144,4448,1160,result_119.elf
20064,208,2864,23136,5a60,except_120.elf,21128,192,1288,22608,5850,result_120.elf
343976,208,4904,349088,553a0,except_121.elf,650200,192,3328,653720,9f998,result_121.elf
207448,208,3608,211264,33940,except_122.elf,578504,192,2040,580736,8dc80,result_122.elf
77424,208,3608,81240,13d58,except_123.elf,81816,192,2040,84048,14850,result_123.elf
103360,208,3400,106968,1a1d8,except_124.elf,228712,192,1832,230736,38550,result_124.elf
35208,208,3080,38496,9660,except_125.elf,44024,192,1512,45728,b2a0,result_125.elf
45056,208,2760,48024,bb98,except_126.elf,55384,192,1192,56768,ddc0,result_126.elf
52616,208,2880,55704,d998,except_127.elf,109240,192,1312,110744,1b098,result_127.elf
87792,208,3144,91144,16408,except_128.elf,135864,192,1568,137624,21998,result_128.elf
22464,208,2792,25464,6378,except_129.elf,24680,192,1224,26096,65f0,result_129.elf
58720,208,2792,61720,f118,except_130.elf,94304,192,1224,95720,175e8,result_130.elf
80856,208,3104,84168,148c8,except_131.elf,163584,192,1536,165312,285c0,result_131.elf
99096,208,3208,102512,19070,except_132.elf,152800,192,1640,154632,25c08,result_132.elf
119656,208,3624,123488,1e260,except_133.elf,191976,192,2048,194216,2f6a8,result_133.elf
42640,208,2912,45760,b2c0,except_134.elf,70688,192,1336,72216,11a18,result_134.elf
145520,208,3664,149392,24790,except_135.elf,302768,192,2096,305056,4a7a0,result_135.elf
82640,208,3080,85928,14fa8,except_136.elf,165568,192,1512,167272,28d68,result_136.elf
11568,208,2640,14416,3850,except_137.elf,4128,192,1064,5384,1508,result_137.elf
10568,208,2624,13400,3458,except_138.elf,1712,192,1056,2960,b90,result_138.elf
55680,208,3056,58944,e640,except_139.elf,92384,192,1488,94064,16f70,result_139.elf
211584,208,3944,215736,34ab8,except_140.elf,544512,192,2376,547080,85908,result_140.elf
131288,208,4200,135696,21210,except_141.elf,204184,192,2624,207000,32898,result_141.elf
15024,208,2784,18016,4660,except_142.elf,6968,192,1208,8368,20b0,result_142.elf
96920,208,3080,100208,18770,except_143.elf,167672,192,1512,169376,295a0,result_143.elf
108032,208,3440,111680,1b440,except_144.elf,195728,192,1872,197792,304a0,result_144.elf
788,192,1492,2472,9a8,except_145.elf,856,192,1088,2136,858,result_145.elf
65000,208,2992,68200,10a68,except_146.elf,122704,192,1424,124320,1e5a0,result_146.elf
13128,208,2608,15944,3e48,except_147.elf,5368,192,1040,6600,19c8,result_147.elf
86872,208,3008,90088,15fe8,except_148.elf,132584,192,1440,134216,20c48,result_148.elf
41744,208,2744,44696,ae98,except_149.elf,57048,192,1176,58416,e430,result_149.elf

